NO ./textures/north.xpm
SO ./textures/south.xpm
WE ./textures/west.xpm
EA ./textures/east.xpm

F 220,100,0
C 135,206,235

11111111111111111111
10000000001100000001
10110000011100000001
10010000000000000001
10000000000000000001
10000001100000000001
10000001100000000001
10000000000000000001
10000000000N00000001
10000000000000000001
10000000000000000001
10000000000000000001
11111111111111111111
