NO ./textures/north.xpm
SO ./textures/south.xpm
WE ./textures/west.xpm
EA ./textures/east.xpm

F 220,100,0
C 135,206,235

             1
11111111111110111111
100000000011000000001
10110000011100000001
10010000000000000001
10000000000000000001
10000001100000000001
10000001100000000001
10000000000000000001
100000000000N0000001
10000000000000000001
10000000000000000001
10000000000000000001
11111111111111111111
